#####
#@`^#
# ` #
#^  #
#####
