  #####
###   #
#^@`  #
### `^#
#^##` #
# # ^ ##
#` *``^#
#   ^  #
########
